GOOG (Alphabet Inc Class C)  Tick DataSet
================================================

Sample File Date : 01-Jul-2020

Full Dataset Dates: 04-Jan-2010 - Last Date : 14-Aug-2020

File Format : {Timestamp (year-month-day hour:minute:second:millisecond), Price, Volume, Exchange (See Below Codes)}

- Volume Numbers are in individual shares 
- Excel will usually fail to open large files directly. 
  To use the data in Excel, open the files using notepad and then break into smaller files or copy/paste into Excel
   
  XASE :  NYSE American (AMEX)
  XNAS :  NASDAQ OMX BX
  XCIS :  National Stock Exchange
  FINRA : FINRA
  CQS :  Consolidated Quote System
  XISX :  International Securities Exchange
  EDGA :  Cboe EDGA
  EDGX :  Cboe EDGX
  XCHI :  Chicago Stock Exchange
  XNYS :  New York Stock Exchange
  ARCX :  NYSE Arca
  XNGS :  Nasdaq
  CTS :  Consolidated Tape System
  OOTC :  OTC Bulletin Board
  XOTC :  OTC Bulletin Board
  PSGM :  OTC Bulletin Board
  PINX :  OTC Bulletin Board
  OTCB :  OTC Bulletin Board
  OTCQ :  OTC Bulletin Board
  IEXG :  IEX
  XCBO  : Chicago Board Options Exchange
  PHLX :  Nasdaq PSX
  BATY :  Cboe BYX
  BATS :  Cboe BZX
  XBOS :  NASDAQ BX Options/ETF


___________________________
copyright FirstRateData.com